R 1280 720
NO ./textures/wall_n1.xpm
SO ./textures/wall_s1.xpm
WE ./textures/wall_w1.xpm
EA ./textures/wall_e1.xpm

S ./textures/sprite_1.xpm
F 35,35,35
C 255,255,200

        1111111111111111111111111
        1000000000110000000000001
        1011000001110000002000001
        100100000000000000000000111
111111111000000001110000000000001
100000000000000001110111111111111
11110111111100011100000010001
11110111111100011101010010001
11000000110100011100000000201
10002000000000000000000010001
10000000000000001101010010001
11000001110020011111011110N0111
11110111111000110111101000111
111111111111111111111111111
